111111111111
100E0000C001
100P00000001
10C000000011
111111111111