1111111111
100E0C0001
1000P00001
1000000001
1000010001
1000010001
1000010001
1000000001
1000000001
1111111111