1111111111
110E0C0001
1P00001001
1000100111
1111111111