111111111111
1P0E00000001
10000000C001
10C000000011
111111111111