1111111111
110E0C0001
1000P00001
100C0C0001
1111111111