111111111111111
100E00000000001
1000000P0000001
10000000000C001
111111111111111