1111111111
1C000000E1
1111111111