1111111111111111111111111111111111
10000000000000C00000C0000000000011
10100101001000001010010P0000010001
1010010010101010001001000000010101
100E0000C00C000000000000000000C11
1111111111111111111111111111111111