1111111111
1C000P00E0
1111111111