111111111111111111111111111
10000000CC0000000000000E001
1000000C00C00000000C000C001
100000C0000C0000000CCCCC001
10000CCC0C0CC000000C000C001
1000C00000000C00000C000C001
1P0C0000000000C000000000001
111111111111111111111111111