111111111111111111111111111
10000000CC0000000000000E001
1000000C10C10000001C000C001
100000C1000C1000001CCCCC001
10000CCC1C0CC100001C000C001
1000C10000000C10001C000C001
1P0C1000000000C100000000001
111111111111111111111111111