1111111111
100E0C0001
10C0101C01
1000100001
1010010001
1010P0C001
1000010001
11101C0101
10C0000001
1111111111