111111111111111111111
1E0010C00000000000001
100011100000000000001
1P0000000000000000001
100000000000000000001
100C00000000000000001
100000000000000000001
100000C00000000000001
1E0000000000000000001
100000111000000000001
100000000100000000001
100000000011011110001
100000000000000000001
100111111011100000001
100000000000011110001
100000000000000000001
100000000000000000001
100000000000000000001
100010000000000000001
101111110000000000001
100000010000000000001
100001110000000000001
100000000000000000001
111111111111111111111
