111111111111111111111111111111111111111111111111111111111111111111111111111111111
10000000CC0000000000000E00110000000000000000000000100100000000C0000000000000E0011
1000000C10C10000000C000C00111000000000000000000000000010000000C000000000000000001
100000C1000C1000000CCCCC000000000000000000000000000000000000000C00000000000000001
10000CCC1C0CC100001C000C00111000000000000000000000000010000000C000000000000000001
1000C10000000C10001C000C001110000000000000000000000000000000000C00000000000000001
1P0C1000000000C10000000001111110000000000C00000000000010000000C000000000000000001
1111111111111100011110011111110000000000000C000000000001000000CC00000000000000001
10000000000000C100000000001111000000000000000C00000000010000C0C000000000000000001
100C0000000000C10000000000111100000000000000000C0000000000000000C000CC00C0000C001
100C1000000000C10000000001111000000000000000000000C000010000C00C0C00000CC00000001
100C0000000000C1000000000011100000000C00000000000000C00000000000C00000000000C0001
100C10000001100C1000000000111000000000000000000000000C010000000C000000000000C0001
100C00001111000000C0000000011100000000C00000000000000010000000CC00000000000000001
111111111111111111111111111111111111111111111111111111111111111111111111111111111